###########
##-----##-#
P--###-##-E
#----#----#
###########